0 0 0 0 0 0 0 0 0 0 0 0 0 0 0 0 0 0 0 0 0 0 0 0 0 0 0 0 0 0 0 0 0 0 0 0 0 0 0 0 0 0 0 0 0 0 0 0 0 0 0 0 0 0 0 0 0 0 0 0 0 0 0 0
0 0 0 0 0 0 0 0 0 0 0 0 0 0 0 0 0 0 0 0 0 0 0 0 0 0 0 0 0 0 0 0 0 0 0 0 0 0 0 0 0 0 0 0 0 0 0 0 0 0 0 0 0 0 0 0 0 0 0 0 0 0 0 0
0 0 0 0 0 0 0 0 0 0 0 0 0 0 0 0 0 0 0 0 0 0 0 0 0 0 0 0 0 0 0 0 0 0 0 0 0 0 0 0 0 0 0 0 0 0 0 0 0 0 0 0 0 0 0 0 0 0 0 0 0 0 0 0
0 0 0 0 0 0 0 0 0 0 0 0 0 0 0 0 0 0 0 0 0 0 0 0 0 0 0 0 0 0 0 0 0 0 0 0 0 0 0 0 0 0 0 0 1 2 3 4 3 4 5 6 0 0 7 8 0 0 5 6 3 4 5 6
0 0 0 0 0 0 0 0 0 0 0 0 0 0 0 0 0 0 0 0 0 0 0 0 0 0 0 0 0 0 0 0 0 0 0 0 0 0 0 0 0 0 0 0 9 10 5 6 11 12 5 6 0 0 8 13 0 0 5 6 11 12 5 6
0 0 0 0 0 0 0 0 0 0 0 0 0 0 0 0 0 0 0 0 0 0 0 0 0 0 0 0 0 0 0 0 0 0 0 0 0 0 0 0 0 0 0 0 1 2 5 6 0 0 5 6 0 0 7 8 0 0 5 6 0 0 5 6
14 14 14 14 14 14 14 14 14 14 14 14 14 14 14 14 5 6 14 14 14 14 14 14 14 14 14 14 14 14 14 14 14 14 14 14 14 14 14 14 14 14 14 14 14 14 5 6 0 0 5 6 0 0 15 16 0 0 5 6 0 0 5 6
17 18 17 18 17 18 17 18 17 18 17 18 17 18 17 18 5 6 17 18 17 18 14 14 17 18 17 18 17 18 17 18 17 18 17 18 17 18 17 18 17 18 17 18 17 18 5 6 0 0 5 6 0 0 16 15 0 0 5 6 0 0 5 6
19 20 19 20 19 20 19 20 19 20 19 20 19 20 19 20 5 6 19 20 19 20 19 20 19 20 21 11 12 22 19 20 19 20 19 20 19 20 19 20 19 20 19 20 19 20 5 6 0 0 5 6 23 24 8 13 23 24 5 6 0 0 5 6
13 25 13 25 13 25 13 25 13 25 13 25 13 25 13 25 5 6 13 25 13 25 13 25 13 25 26 0 0 27 13 25 13 25 13 25 13 25 13 25 13 25 13 25 13 25 5 6 0 0 5 6 3 4 7 8 3 4 5 6 0 0 14 14
15 16 15 16 21 11 12 22 15 16 15 16 15 16 15 16 5 6 15 14 14 14 14 14 14 14 14 14 14 14 14 14 14 14 14 14 14 14 14 14 14 16 15 16 15 16 14 14 23 24 5 6 15 16 8 13 15 16 5 6 23 24 5 6
16 15 16 15 26 0 0 27 16 15 16 15 16 15 16 15 5 6 14 14 0 0 0 0 0 0 0 0 0 0 0 0 0 0 0 0 0 0 0 0 0 14 16 15 16 15 14 14 3 4 14 14 16 15 7 8 16 15 14 14 3 4 5 6
14 14 14 14 14 14 14 14 14 14 14 14 14 14 14 14 14 14 0 0 0 0 0 0 0 0 0 0 0 0 0 0 0 0 0 0 0 0 0 0 0 0 14 14 14 14 14 14 15 16 5 6 15 16 15 16 15 16 5 6 15 16 5 6
0 0 0 0 0 0 0 0 0 0 0 0 0 0 0 0 0 0 0 0 0 0 0 0 0 0 0 0 0 0 0 0 0 0 0 0 0 0 0 0 0 0 0 0 0 0 0 0 14 14 14 14 14 14 14 14 14 14 14 14 14 14 14 14
0 0 0 0 0 0 0 0 0 0 0 0 0 0 0 0 0 0 0 0 0 0 0 0 0 0 0 0 0 0 0 0 0 0 0 0 0 0 0 0 0 0 0 0 0 0 0 0 0 0 0 0 0 0 0 0 0 0 0 0 0 0 0 0
